R 1200 600

NO ./src/texture/tx.xpm
SO ./src/texture/tx.xpm
WE ./src/texture/tx.xpm
EA ./src/texture/tx.xpm

S ./path_to_the_sprite_texture
F 24, 44, 97
C 45, 152, 218

      11111111111111111111111111111
      10000000000000000000000000001
      10000000000000000000000000001
      10000000000000000000000000001
      10000000000000000000000111111
111111100001100000111011110011
11110111111111011100000010001
11110111111111011101010010001
11000000110101011100000010001
10000000000000001100000010001
10000000000000001100010000001
11000000110101000000000000001
11110111110101000000000000001
10000000001100000100000010001
10000000000000000000000001001
10000000001000010000000001001
10000000001101000000000000001
10000000000100000001010000001
11111111111111111111111111111