R 1200 600

NO ./src/texture/wall.xpm
SO ./src/texture/wall.xpm
WE ./src/texture/wall.xpm
EA ./src/texture/wall.xpm

S ./path_to_the_sprite_texture
F 57, 0, 0
C 45, 152, 218


1111111111111111111111111111111111111111111111111111111
1000000000000000000000000000000000000000000000000000001
1000000000000000000000000000000000000000000000000000001
1111111111111110000000000000000000000000000000000000001
       111110000000000000000011111111111111000000000001
 11111111000000000011110000000000011    111000000000001
 1000000000000000001  10000000000111   1100000011111111
 1100000000000000001  10000000000001   1100000000011    
 1111000001111111111  11111110011111   1111111000011    
11111000001                 10001         111100011   
 11110000011111111     111111101111111111111000001111 
 11000000000000011    11000000000000000000000000000011 
 10000000000000001    100000000000000000000111111000111
 11000000000000011    1100000000000111110001   11000011
 1000000N000000011     1000000000001   10001   10000011
 11100000000000011111111000000000001   10001   11000011
  1111000000000000000000000000000011   10001  110000011
  1100000000000000000000000001111111   11111  100011111
  11111000000000000000000000000111           1100011   
1110000000000000000000000000011111111111111111100011   
1111110000000000000000000000000000000000000000000011   
    111111000000000000000000000000000000000000000011   
    111111000000000000000001111111111111111110000011   
        1111111000000000001111            1111111111  
            111111111111111                           