R 1200 800

NO ./src/texture/1000.xpm
SO ./src/texture/1000.xpm
WE ./src/texture/1000.xpm
EA ./src/texture/1000.xpm

S ./src/texture/sprite.xpm
F 47, 53, 40
C 45, 152, 218


                                                       1111111111111111111111111111111111111111111
                                                       10000000000000000000000000000000000000000011
                                                       100000000000000000000000000000000000000000011
                                                       1000000000000000000000000000000000000000000011
             1111111  111111111111111111111            10000000000000000000000000000000000000000000011
          1111100001  100011110000000000001            100000000000000000000000000000000000000000000011
       111110000000111100000000012111111101            1000000000000000000000000000000000000000000000011
 11111111000000000000000000000000011    101            10000000000000000000000000000000000000000000000011
 10000000000000000011110000020000111   11011111111     100000000000000000000000000000000000000000000000011
 1100000000000000001  10000000000001   11000000001     1000000000000000000000000000000000000000000000000011
 1111111111111111111  11111100111111   11111111101     10000000000000000000000000000000000000000000000000011
                           10001               101     1000000000000000S0000000000000000000000000000000000011
 11111111111111111     111110001111111111111   101111  1000000000000000000000000000200020000000000000000000011
 11000000000000011    1100000000000000000001   1000011110000000000000000000000000002000000000000000000000000011
 10000000000000001    1000000000000000000001   11000000000000000000000000000000000020000000000000000000000000011
 11000000000000011    1100000000000111110001   1000001 10000000000000000000000000000000000000000000000000000011
 1000000000000001      1000000000001   10001   1000001 1000000000000000000000000000000000000000000000000000011
 11100000000000011111111000000000001   10001   11000011100000000000000000000000000000000000000000000000000011
  1111000000000000001000000000000001   10001  11100000000000000000000000000000000000000000000000000000000011
  1100000000000000020000000001111111   11111  1000111111000000000000000000000000000000000000000000000000011
  11111000000000000000000000000001            10001    100000000000000000000000000000000000000000000000011
111000000000000000000000000001111111111111111110001    10000000000000000000000000000000000000000000000011
111111000000000000000000020000000000000000000000001    1000000000000000000000000000000000000000000000011
    11111100000000000000000011111111111111111000001    100000000000000000000000000000000000000000000011
        1111110000000000111111            111111111    10000000000000000000000000000000000000000000011
            11111111111111                             1000000000000000000000000000000000000000000011
                                                       100000000000000000000000000000000000000000011
                                                       10000000000000000000000000000000000000000011
                                                       11111111111111111111111111111111111111111111